DONALD J. TRUMP FOR PRESIDENT, INC.: secure.winred.com/ 
BIDEN FOR PRESIDENT: www.iwillvote.com/voting/location 
SENATE LEADERSHIP FUND: www.senateleadershipfund.org/ 
CASA IN ACTION, INC.: www.casainaction.org/ 
BOB CASEY FOR SENATE INC: secure.actblue.com/ 
ANGIE CRAIG FOR CONGRESS: www.angiecraig.com/ 
CONSERVATIVE BUZZ LLC: www.conservativebuzz.com/poll/who-won 
HOMEOWNERS AND TENANTS UNITED: <dynamically generated based on landing page content>/ 
ARIZONA FAMILIES FIRST: www.arizonafamiliesfirst.com/ 
DNC SERVICES CORP / DEMOCRATIC NATIONAL COMMITTEE: www.iwillvote.com/polling/location 
CALIFORNIANS FOR EQUAL RIGHTS, NO ON 16: www.californiansforequalrights.org/ 
FRIENDS OF DAN FEEHAN: www.danfeehan.com/how/tovote 
KEEP KENTUCKY GREAT: www.keepkentuckygreat.com/ 
JOE CUNNINGHAM FOR CONGRESS: www.joecunninghamforcongress.com/ 
FRIENDS OF SPENCER COX: <dynamically generated based on landing page content>/ 
TINA SMITH FOR MINNESOTA: www.tinaforminnesota.com/ 
JOE COLLINS FOR CONGRESS: secure.joecollinsforcongress.com/ 
A HEALTHY FUTURE, LLC: www.ahealthyfuture.org/ 
CARTWRIGHT FOR CONGRESS: www.cartwrightcongress.com/ 
SHAHEEN FOR SENATE: secure.actblue.com/shaheen 
THE LINCOLN PROJECT: www.republicansforbiden.net/ 
COLLINS FOR SENATOR: www.susancollins.com/ 
DEMOCRATIC PARTY OF WISCONSIN: secure.actblue.com/princessbride 
PETERS FOR MICHIGAN: www.petersformichigan.com/ 
NARAL PRO-CHOICE AMERICA: secure.actblue.com/naral/donate 
JACKIE GORDON FOR CONGRESS: secure.actblue.com/ 
MICHIGAN DEMOCRATIC STATE CENTRAL COMMITTEE: www.michigandems.com/ 
MISSION MEDIA, LLC: elections.maryland.gov/ 
DMFI PAC: www.dmfipac.org/ 
NRSC: www.hickenlooperfactcheck.com/learnmore 
MICHIGAN REPUBLICAN PARTY: www.invisiblegarypeters.com/ 
ALASKANS FOR DAN SULLIVAN: secure.winred.com/ 
ALEXANDRIA OCASIO-CORTEZ FOR CONGRESS: secure.actblue.com/donate/aoc 
FEDERATION FOR AMERICAN IMMIGRATION REFORM: www.fairus.org/ 
BOLLIER FOR KANSAS: secure.actblue.com/ 
WARNOCK FOR GEORGIA: secure.actblue.com/donate-now 
314 ACTION FUND: www.314action.org/ 
COLORADO DEMOCRATIC PARTY: www.coloradodems.org/ 
DEFENDARIZONA: www.defendarizona.org/ 
A STRONGER MISSOURI: www.strongermissouri.com/ 
CHANGE NOW: www.healthcarevoter.org/ 
VOTEVETS: www.votevets.org/ 
VOTE YES FOR FAIRNESS: www.voteyesforfairness.com/ 
CLUB FOR GROWTH ACTION: www.votenoonbourdeaux.com/ 
DCCC: www.2020priorities.com/ 
BIDEN VICTORY FUND: secure.actblue.com/ 
2020 OUR OREGON VOTER GUIDE PAC: www.theoregonvoterguide.com/ 
PIEDMONT RISING, INC.: www.wral.com/ 
JAIME HARRISON FOR US SENATE: secure.actblue.com/ 
YES FOR A HEALTHY FUTURE: www.yeson108.org/ 
REPUBLICAN NATIONAL COMMITTEE: vote.donaldjtrump.com/ 
DFL HOUSE CAUCUS: vote.minnesotavaluesproject.com/ 
MCSALLY FOR SENATE INC: action.mcsallyforsenate.com/ 
AMERICANS FOR PROSPERITY: americansforprosperity.ivolunteers.com/ 
CAROLYN FOR CONGRESS: www.carolyn4congress.com/ 
DEAN PHILLIPS FOR CONGRESS: www.phillipsforcongress.org/ 
KATIE PORTER FOR CONGRESS: secure.actblue.com/katieporter/donate 
ELAINE FOR CONGRESS: www.elaineforcongress.com/ 
TEAM GRAHAM, INC.: secure.winred.com/ 
ONE NATION: www.onenationamerica.org/ 
SMP: secure.actblue.com/ 
JOSH GOTTHEIMER FOR CONGRESS: secure.actblue.com/ 
HOUSE MAJORITY PAC: www.thehousemajoritypac.com/ 
FRIENDS OF CHERI BUSTOS: www.cheribustos.com/ 
JON OSSOFF FOR SENATE: www.electjon.com/ 
PRIORITIES USA ACTION & SMP: www.iwillvote.com/ 
YES ON 16, OPPORTUNITY FOR ALL COALITION, SPONSORED BY CIVIL RIGHTS ORGANIZATIONS: www.voteyesonprop16.org/ 
SHARICE FOR CONGRESS: secure.actblue.com/ 
HANDEL FOR CONGRESS, INC.: www.karenhandel.com/ 
EMERGING AMERICAN MAJORITIES: www.americanleadershipcommittee.org/ 
DITCH FUND: www.amymcgrath.com/ 
YES ON 24, CALIFORNIANS FOR CONSUMER PRIVACY: www.caprivacy.org/ 
WENDY DAVIS FOR CONGRESS: www.chipputspoliticsfirst.com/ 
NO ON PROP 21: CALIFORNIANS FOR RESPONSIBLE HOUSING, A COALITION OF SENIORS, VETERANS, AFFORDABLE HOUSING ADVOCATES, LABOR & SOCIAL JUSTICE ORGANIZATIONS, SPONSORED BY CALIFORNIA APARTMENT ASSOCIATION: www.noonprop21.vote/ 
YES ON PROP 25, A COALITION OF JUSTICE REFORM AND LABOR ORGANIZATIONS: www.yesoncaprop25.com/ 
MARSY'S LAW FOR KENTUCKY, LLC: www.victimsrightsky.com/ 
ELISSA SLOTKIN FOR CONGRESS: www.elissaslotkin.us/ 
MONTANANS FOR BULLOCK: secure.actblue.com/stevebullock/donate 
END CITIZENS UNITED: www.specialinterestherrell.com/ 
LEADING COLORADO FORWARD: www.leadingcoloradoforward.com/suzanne-staiert 
MOVEON.ORG POLITICAL ACTION: act.moveon.org/ 
THOM TILLIS COMMITTEE: secure.winred.com/ 
GOOD JOBS MT: www.montanavotes2020.com/ 
MONTANANS FOR TESTER: secure.actblue.com/ 
WOMEN VOTE!: www.iowawomenvote.com/ 
FRIENDS OF LUCY MCBATH: www.lucyforcongress.com/ 
DOUG JONES FOR SENATE COMMITTEE: www.tommytuberville.com/ 
A4 MEDIA DATA SOLUTIONS LLC: www.timknoppfacts.com/ 
COOPER FOR NORTH CAROLINA: secure.actblue.com/ 
TAMMY BALDWIN FOR SENATE: secure.actblue.com/ 
SPANBERGER FOR CONGRESS: www.abigailspanberger.com/ 
AMERICANS FOR PROSPERITY ACTION INC: afpaction.ivolunteers.com/ 
MARTIN HEINRICH FOR SENATE: heinrich.cp.bsd.net/ 
COLLECTIVE FUTURE: www.votetolive.org/ 
NO ON PROP 15 - STOP HIGHER PROPERTY TAXES AND SAVE PROP 13 - A COALITION OF CALIFORNIA HOMEOWNERS, TAXPAYERS, AND BUSINESSES: www.noonprop15.org/ 
THERESA GREENFIELD FOR IOWA, INC.: secure.actblue.com/ 
GEORGIANS FOR KELLY LOEFFLER: kellyforsenate.ivolunteers.com/ 
MJ FOR TEXAS: www.mjfortexas.com/ 
CANDACE FOR 24: www.iwillvote.com/ 
CITIZENS FOR FREE ENTERPRISE: landing.citizensforfreeenterprise.com/ 
CHISPA AZ PAC: www.accvoterguide.com/ 
COLIN ALLRED FOR CONGRESS: www.colinallred.com/ 
AMERICA FIRST ACTION, INC.: www.american-herald.com/ 
PRESERVE AMERICA PAC: www.preserveamericapac.com/ 
FOUR MORE YEARS PAC: secure.redsenate.org/ 
DR. AL GROSS FOR U.S. SENATE: www.dralgrossak.com/ 
CONGRESSIONAL LEADERSHIP FUND: www.tooliberalforny22.com/learnmore 
AMERICA FIRST POLICIES INC.: www.amyconeybarrett.info/ 
SRI FOR CONGRESS: www.sri2020.com/ 
SCHOLTEN FOR CONGRESS: www.hillaryscholten.com/ 
TRUMP MAKE AMERICA GREAT AGAIN COMMITTEE: secure.winred.com/ 
LAUREN UNDERWOOD FOR CONGRESS: www.underwoodforcongress.com/ 
CUMMINGS FOR CONGRESS: www.cummings2020.com/ 
CATHOLICVOTE.ORG: www.catholicvote.org/ 
NEXTGEN CLIMATE ACTION COMMITTEE: www.nextgenamerica.org/ 
STEVE DAINES FOR MONTANA: secure.winred.com/ 
KIM KLACIK FOR CONGRESS: secure.winred.com/ 
REPUBLICAN SENATE CAMPAIGN COMMITTEE: www.citizensforblessing.com/ 
SCHOOLS AND COMMUNITIES FIRST: <dynamically generated based on landing page content>/ 
NYS DEMOCRATIC SENATE CAMPAIGN COMMITTEE (NYS DSCC): www.realrobastorino.com/ 
AMY MCGRATH FOR SENATE, INC.: www.amymcgrath.com/ 
HICKENLOOPER FOR COLORADO: www.hickenlooper.com/ 
JOHN JAMES FOR SENATE, INC.: secure.winred.com/john-james/action-10302020 
KENDRA HORN FOR CONGRESS: www.kendrahorn.com/vote 
CHRIS COONS FOR DELAWARE: secure.actblue.com/ 
TEXANS FOR SENATOR JOHN CORNYN INC.: secure.winred.com/ 
NEW DAY MEDIA SERVICES, LLC: www.healthcarechampionaward.org/ 
STEIL FOR WISCONSIN, INC.: www.bryansteil.com/ 
DR KIM SCHRIER FOR CONGRESS: www.drkimschrier.com/ 
LAUREN BOEBERT FOR CONGRESS: www.laurenforcolorado.com/ 
ZELDIN FOR CONGRESS: www.zeldinforcongress.com/ 
FRIENDS OF JULIE SLOMSKI: pavoterservices.pa.gov/ 
BLACK PAC: www.blackfloridavote.com/ 
MARKETFUEL SUBSCRIPTION SERVICES: www.theepochtimes.com/2020/election 
PRIORITIES USA ACTION: www.iwillvote.com/ 
MIKEBLOOMBERG.COM LLC: www.mikebloomberg.com/ 
MAX ROSE FOR CONGRESS: secure.actblue.com/ 
COLLINS FOR SENATE, INC.: www.dougforgeorgia.com/ 
AMERICAN VALUES FUND: secure.redsenate.org/ 
MICHELLE STEEL FOR CONGRESS: www.michellesteelca.com/ 
HARLEY ROUDA FOR CONGRESS: www.michellesteelcorrupt.com/ 
CALIFORNIA SECRETARY OF STATE: vote.ca.gov/votesafe/california 
MARK KELLY FOR SENATE: secure.actblue.com/ 
BRIAN FITZPATRICK FOR CONGRESS: www.noshowfinello.com/ 
HALEY STEVENS FOR CONGRESS: www.haleystevensforcongress.com/ 
ALL VOTERS VOTE, INC.: www.allvotersvote.org/ 
SPALDING GROUP INC: www.trumpstore2020.com/ 
GEORGE SCOTT FOR PA 15: pavoterservices.pa.gov/ 
PRIORITIES USA ACTION AND SMP: www.onenorthcarolina.net/ 
DAVID TRONE FOR CONGRESS, INC: www.davidtrone.com/ 
JOE EDWARD COLLINS III: secure.winred.com/ 
